TILEMAP
72 16 							-- Size of tile map in tiles
16 32 							-- Tile size & block size
images/blocks.png 			-- Tilesheet
2 2								-- Number of tiles in tilesheet
........................................................................
........................................................................
........................................................................
........................................................................
........................................................................
........................................................................
........................................................................
..4444444444444444444444444444444444444444444444111111114444444444111111
..3333333333333333333333333333333333333333333333111111113333333333111111
223333333344444433333333333333333333333333333333........3333333333......
223333333333333333333333334444333333333344444433222222223333333333222222
222222222233333344333344333333333333333333333333222222223333333333222222
222222222233333333333333223333222222333333333322222222223333333333222222
222222222222222222444422222222222222224444222222222222222222222222222222
222222222222222222222222222222222222222222222222222222222222222222222222

